18 21
000000000000000000000
00a000000000000000000
000000000002220000000
000000000000000000000
000000000000000000000
000112221111000000000
0000000000000000a0000
000000000000000000000
000000000000000000000
000000000000000000000
000000000000000000000
000000000111111122000
000000000000000000000
000000000000000000000
000000000000000000000
000002200000000000000
000000000000000000000
000000000000000000000
