22 32
22222222222222222222222222222222
20000000000000000000000000022222
20000000000000000000000000000002
200.0000000000000000000000000002
20000000000000000000000000000002
20000000000000000000000000000002
20000000000000000000000000000002
20000011111111000000000000000002
20000000000000000000000000000002
20000000000000000000000000000002
20000000000000000000000000000002
20000000000000000000000000000002
20000000000000000000000000000002
200000000000000B0000000000000002
20000000000000000000000000000002
20000001112222111111000000000002
20000000000000000000000000000002
20000000000000000000000000000002
2000000000000000000000000A000002
20000000000000000000000000000002
20000000000000000000000000000002
22222222222222222222222222222222