18 21
000000000000011000000
000000000000011000000
000000000000011000000
000010000000011000000
00001000a000011000000
000010000000000000000
000010000000000000000
000000000000000000000
000000000000000000000
000000000000000000000
000011111111100001000
000000000000000000000
000000000000000000000
000000000000000000000
000000000000000000000
0000000000000000a0000
000000000000000000000
000000000000000000000
