22 32
22222222222222222222222222222222
20000000000000000000000000022222
20000000000000000000000000000002
200.0000000000000000000000000002
20000000000000000000000000000002
20000000000000000000000000000002
20011111111000000000000000000002
20000000000000000000000000000002
20000000000000000000000000000002
20000000000000000000100000000002
20000000000000000000100000000002
20000000000000000000100000000002
200000000000000000001000000A0002
20000000000000000000100000000002
20000000000000000000000000000002
20000000000000000000000000000002
200A0000000000000000000000000002
20000000000000000000000000000002
20000000011111222211111100000002
20000000000000000000000000000002
20000000000000000000A00000000002
22222222222222222222222222222222