22222222222222222222222222222222
20000000000000000000000020000002
20000000000002000000000000A00002
20000020020000000000000000000002
20000000000000000000020000000002
20000022000000000200000000000002
20200000000000000002002A00000002
20020020000020000000000000000002
20000020022000020002000000002002
20000000002000000000000000000002
20000000000000000200000200000002
20020000000000000200000000000002
20000000020000000200000000220002
2000000002000.000000000000022002
20000000000000000002000000000002
22020000002000000000000000000002
20000000000000020220000020200002
20200000000000000000002000000002
200002200000020000000A0020000002
20000000000000000000000000000002
2000002A000000000000000000022002
22222222222222222222222222222222
